0000000040000000
0000000000000020
0000010000000000
0000000100000000
0030000000000000
0000000000001000
0003000000000000
0000000000400000
0000020000000000
0000000002000000
0000003000000040
0000000000000000