0000000000200000
0000100000000000
0400000000000040
0000000200000000
0000000000010000
0030000000000000
0000000000004000
0000020030000000
0000000000000000
0000000000000000
0200000000030000
0000000000000000