0000004000000000
0000000000000200
0000003000000000
0000200000000400
0040000000000000
0000000000000000
0000000000100000
0020000000000000
0000000400000300
0000300000000000
0040000000000200
0000000000000000