0000000040000000
0000200000000200
0000000000100000
0000000000000300
0004000000000000
0300000000000000
0000000100000000
0000000000002000
0000000000000000
0010000000000000
0000000004003000
0000000000000000