0000020000000000
0001000000000000
0000000000000300
0000000004000000
0400000000000000
0000002003000000
0000000000000000
0000000400002000
0000000000001000
0030000000000000
0000000000040000
0000000000000000