0000004000000200
0000000000000000
0000003000000000
0000002000000400
0040000000000000
0000000000000000
0000000000100000
0020000000000000
0000000400000300
0000100000000000
0040000003000200
0000000000000000