0000000000000000
0000100000000000
0020000000020000
0000000300000040
0002000000000000
0000000000000000
0000000000001000
0030000000000000
0000000000000040
0000040000000000
0040000000300000
0000000000000000