0000000000000000
0010000000000000
0000000200000300
0000000000000000
0000002000000000
0020000000000000
0000000000000100
0000000000000000
0000000010000000
0003020000030000
0000000000000000
0000000000000000