0010000000000000
0000200000000000
0000000000010000
0000000000000000
0400000003002000
0000200000000000
0000000000000000
0000300000000000
0000000100000000
0000020000000000
0000040000003000
0000000000000000