0002000000000000
0000000000000000
0000002000000000
0001000000000000
0000000010000000
0000000000300000
0000000400000000
0000000000000000
0000300000000000
0000010000000000
0004000000003000
0000000000000000